1111111111111111111111111111111111111111
1000000000000000000000000000000000000001
1000000000000000000000000000000000000001
1000000000000000000000000000000000000001
10000000000000000000000000000000000d0001
1000000000000000000000000000000000000001
1000000000000000000000000000000000111001
1000000000000000000000l000c0r00000001001
1000000000000000000000111111100000001001
1000000000000000000000000000000000001001
1000000000000000000000000000000000001001
10000000000l0c00r00000000000000000001001
1000000000011111100000000000000000001001
10000000000100000000000l00000c000r001001
1000000000010000000000011111111111001001
1000000000000000000000000000000000000001
100k000000000000000000000000000000000001
1000000000000000000000000000000000000001
1111110000000000000000000000000001000001
1000010000000000000000000000000001000001
1000010000000000000000000000001000000001
100001l00c000r00000000000000001000000001
10000111111111000000l00c00r0000000000001
1000000000000000000011111110000000000001
1000000000000000000000000000000000000001
1000000000000000000000000000000a00000001
1000000000000000000000000000000000000001
1000000000000000000000000000111111100001
1000000000000000000000000000000000000001
100p000000000000000000000000000000000001
1000000000l00000000c0000000000000000r001
1111111111111111111111111111111111111111