1111111111111111111111111111111111111111
10000000000000000000k0000000000000000001
1000000000000000000000000000000000000001
1000000000000000000000000000000000000001
1111111100000000000111100000000000000001
1000000100000000000000000000000000000001
10000001l0c00r00000000000000010000001111
100000011111110000000000l0c0r10000000001
1000000100000000000000001111110001000d01
1000000100000000000000000000000001000001
1000011100000000010000000000000001111111
10000100000l0c00r00000000000000000001001
1111110000011111100000000000000000001001
10000000000100000000000l00000c000r001001
1000000000010000000000011111111111001001
1000000000000000000000000000000000001001
100k000000000000000000000000000000001001
1l000000c000r000000000000000000000001001
1111111111111000000000000000000001111001
1000000000011000000000000000000000001001
1000000000110000000000000000001000001001
1000000001100000000000000000001000001001
111111111100000000l000c00r00000000001001
1000000000000000001111111110000000001001
1000000000000000000000000000000000001001
10000000000000000000000000000000a0001001
1000000000000000000000000000000000001001
1000000000000000000000000000111111111001
1000000000000000000000000000001000000001
100p000000000000000000000000001000000001
1000000000l00000000c000000000r1000000001
1111111111111111111111111111111111111111