1111111111111111111111111111111111111111
1000000000000000000000000000010000000001
1000000000000000000000000000010d00000001
1000000000000000000000000000010000000001
10000000000000000000000000k0011110000001
1000000000000000000000000000010000000001
1000000000000000000000000000010000000001
1000000000000000000000000000010000lc00r1
10000000000000000000000lc000r10000111111
1000000000000000000000011111110000000001
1000000000000000000000111111110000000001
1000000000000000000001111111110000000001
1000000000000000000001111111111000000001
1000000lc0000r00000001000000000000000001
1000000111111100000000000000000000000001
10000000111110000000000000lc00r000000001
1000000000000000000000000011111000000001
1000000000000000000000000001110000000011
1110000000000000000011000000000000000001
11000000000000000000000000000900000000k1
1000000000000000000000000000000000000001
1000010000000000000000000000000000000001
1000000000000000000000000000000000000001
1000000000000000000000000000000000000001
1000000000001111000000000000000000000001
1000000000000110000000000000000000000001
100000000000000000000lcr0000000000000001
1000000000000000000001110000000000000001
1000000000000000000001110000000000000001
1000p000000000000000011100000a000000k001
10000000l00000000c00r1110000000000000001
1111111111111111111111111111111111111111