1111111111111111111111111111111111111111
1000000000000000000000000110000000000001
1000000000000000000000000110000000000001
1000000k0000000000000000011000000000k001
1000000000000000000000000110000000000001
100000000000000000000k000110000000000001
1000000000000000000000000111111000111111
1000000000000000001111111110000000000001
100000000lc0r000001111111110000000000001
100000000111100000000000000000lc0r000001
1000010000000000000000000000001111000001
1000000000000000000000000000000000000001
1100000000000000001111111110000000000001
1000000000000000000000000000000000000001
1000000000000000000000000000000000001111
1000000000000000000000000000000000000001
1000000000001100000000000000000000000d01
1000100000000000000000000000000000000001
1000000000000000000000000000000000001111
1000000000000000000000000000000000000001
1000000000000000000000000000000000000001
1111111111111111110000000000000000000001
11111k1111111111110000000000000000000001
100000000000000011lc000r0000000000000001
1000000000000000111111110000000000000001
1000000000000000110000000000000000000001
100000000000000111000000000000lc000r0001
1100000000000000000000000000001111110001
1000000000000000000000000000000000000001
10000p000000000000000000000a000000000001
1l000000000000cr110000000000000000000001
1111111111111111111111111111111111111111